XXXXXXXXXXXXX
XP          X
XXXXXXXXXXX X
X           X
X XXXXXXXX XX
X X   X    XX
X   X   XX  X
XXXXXXXXXXXEX